WWWWWWWWWXAAAAXWWWWWWWWW
KKKKKPWSSSAAAASSSWCCCCCC
KKKKKKSSAAAAAAAASSCCCCCC
KKKKKKSSAAAAAAAASSCCCCCC
KKKKKKSSAAAAAAAASSdCCCCC
KKKKKKSSDAAAAAADSSSCCCPW
WKKKdKSSAAAAAAAASSSSSSSX
SSSSSSSSAdAAAAdASSSSSSSW
WSSSSSSSSSSSSSSSSSBBBBBB
NNNNNSSSSSSSSSSSSSDBBBBB
NNNNNNNNSS?????SSSBBBBBB
NNNNNNNNSS?????SSSBBBBBB
NNNNNNNDSS?????SSSBBBBdR
NNNNNNNNSS?????SSSSSSSSW
NNNNNNNNSS?????SSSIIdIIW
NNNNNNdNSS?????SSIIIIIII
WSSSSSSSSS?????SSDIIIIII
XSSSSSSSSSSSSSSSSIIIIIII
WSSSSSSSSHHddHHSSSIIIIIW
PLLLLLdSSHHHHHHSSSSSSSSX
LLLLLLLSSHHHHHDSSSSSSSSW
LLLLLLLSSHHHHHHSSdUUUUUP
LLLLLLLSSHHHHHHSSUUUUUUU
LLLLLLLSSHHHHHHSSUUUUUUU
LLLLLLWXWHHHHHHWSWUUUUUU
